what is your name (informal)	come ti chiami
what is your name (formal)	come si chiama
what nationality are you (informal)	di che nazionalità sei
what nationality are you (formal)	di che nazionalità è
where are you from (informal)	di dove sei
where are you from (formal)	di dov'è
high school	liceo
what is you phone number (informal)	qual è il tuo numero di telefono
what is you phone number (formal)	qual è il suo numero di telefono
when is your birthday (informal)	qual è il tuo compleanno
when is your birthday (formal)	qual è il suo compleanno
what do you do (informal)	che fai
what do you do (formal)	che fa
how old are you (informal)	quanti anni hai
how old are you (formal)	quanti anni ha
what is your email address (informal)	qual è il tuo indirizzo email
what is your email address (formal)	qual è il suo indirizzo email
mechanic	il meccanico
doctor	il medico
lawyer	l'avvocato
nurse	l'infermiera
waiter	il cameriere
teacher	l'insegnante
secretary	la segretaria
pharmacist	il farmacista
factory worker	l'operaio
office worker	l'impiegato
architect	l'architetto
police officer	il poliziotto
taxi driver	il taxista
store worker	la commessa
butcher	il macellaio
hairdresser	la parrucchiera
client	il cliente
farmer	il contadino
bricklayer	il muratore
plumber	l'idraulico
stocky, well-built	robusto
selfish	avaro
generous	generoso
polite	educato
impolite	maleducato
happy	felice
sad	triste
calm (short)	calmo
blackboard	la lavagna
window	la finestra
bag	la borsa
door	la porta
student desk	il banco
newspaper	il giornale
key	la chiave
drawer	il cassetto
sheet of paper	il foglio
eraser	la gomma
teacher's desk	la cattedra
tape recorder	il registratore
geography map	la cartina geografica
chalk	il gesso
television	il televisore
VCR player	il videoregistratore
cabinet	l'armadietto
projector	la lavagna luminosa
strong	forte
weak	debole
right-handed	destro
left-handed	sinistro
medium height	di media altezza
wavy (as in hair)	ondulato
medium length	di media lunghezza
in the pool	in piscina
at the bank	in banca
at the park	al parco
in the library	in biblioteca
at the dentist's	dal dentista
in the classroom	in aula
at the restaurant	al ristorante
at the supermarket	al supermercato
in an airplane	in aereo
at the post office	alla posta
at the theater	al teatro
in prison	in prigione
at the zoo	allo zoo
at the hospital	all'ospedale
in church	in chiesa
at the movies	al cinema
computer	il computer
guitare	la chitarra
cat	il gatto
dog	il cane
fax	il fax
dishwasher	la lavastoviglie
stereo	lo stereo
CD player	il lettore CD
washing machine	la lavatrice
telephone	il telefono
actress	attrice
actor	attore
director (orchestra)	diretiore
director (of movies)	regista
model (m)	modello
singer	cantante
stylest	stilista
ballerina (m)	ballerino
is he married	è sposato
is she married	è sposata
mirror	lo specchio
cream	la crema
cellphone	il cellulare
purse	il borsellino
face mask	la mascherina
eyeglasses	occhiali
hair brush	la spazzola
document	il documento
tissue	il fazzoletto
get to know each other	si conoscono
at symbol (@)	chiocciola
elementary school teacher	il maestro
plus	più
minus	meno
seasons	i stagioni
mustache	i baffi
where do you live (informal)	di dove abiti
where do you live (formal)	di dove abita
